Salary,Interests & Deposits,Total Earning,Food,Electronics,Clothes,Health,Medicine,Entertainment,Total Expense,Savings
19743,19717,39460,2728,2719,2634,2677,2543,2626,15927,59.64%
1779,1763,3542,229,241,228,229,228,230,1385,60.90%
12142,11947,24089,791,831,786,775,794,797,4774,80.18%
22902,22862,45764,5834,5775,5997,5858,5795,5957,35216,23.05%
1500,1560,3060,333,363,311,334,376,349,2066,32.48%
33388,33088,66476,9615,9546,9536,9609,9556,9447,57309,13.79%
14199,14049,28248,4016,4047,4088,4091,4092,4182,24516,13.21%
25905,26127,52032,8824,8667,8718,8548,8506,8596,51859,0.33%
28099,27959,56058,1905,1869,1975,1954,1980,1911,11594,79.32%
14723,14828,29551,701,755,715,692,723,744,4330,85.35%
41180,41566,82746,8866,8904,8750,8898,8999,8820,53237,35.66%
38076,38058,76134,82,91,108,103,103,105,592,99.22%
21475,21472,42947,728,750,709,755,756,743,4441,89.66%
43338,43138,86476,10578,10419,10519,10404,10518,10551,62989,27.16%
43582,42916,86498,14150,14132,14112,14037,14156,14345,84932,1.81%
41553,41712,83265,14046,13925,13866,13612,13816,13999,83264,0.00%
48412,48733,97145,9371,9595,9399,9557,9602,9526,57050,41.27%
296,273,569,39,24,29,30,39,39,200,64.85%
31262,31282,62544,4095,3909,3915,3857,3959,3889,23624,62.23%
20461,20331,40792,6721,6663,6750,6698,6792,6546,40170,1.52%
21468,21223,42691,3797,4053,3796,4075,3919,4069,23709,44.46%
37037,37453,74490,10268,10322,10447,10190,10310,10425,61962,16.82%
7421,7443,14864,415,460,409,466,465,466,2681,81.96%
5983,5777,11760,1213,1267,1211,1311,1159,1255,7416,36.94%
42204,43194,85398,8675,8943,9005,8826,8770,8752,52971,37.97%
28027,28154,56181,3154,3058,3109,3141,3056,3136,18654,66.80%
46905,46564,93469,11366,11270,11224,11190,11167,11363,67580,27.70%
17494,17416,34910,2330,2389,2388,2411,2440,2307,14265,59.14%
39686,39492,79178,638,635,629,615,620,613,3750,95.26%
32037,32651,64688,4845,4796,4853,4714,4788,4835,28831,55.43%
41257,40992,82249,8318,8313,8136,8411,8274,8189,49641,39.65%
6484,6478,12962,1459,1428,1430,1423,1455,1412,8607,33.60%
6879,6860,13739,893,981,982,981,914,908,5659,58.81%
309,322,631,83,106,104,97,81,107,578,8.40%
28200,28356,56556,7241,7298,7534,7349,7258,7286,43966,22.26%
15168,15445,30613,1778,1809,1729,1684,1732,1785,10517,65.65%
16267,16200,32467,2832,3021,2969,2978,2944,2954,17698,45.49%
49231,49709,98940,15994,16056,16181,16170,16034,16006,96441,2.53%
32828,32542,65370,7540,7662,7413,7643,7732,7651,45641,30.18%
36195,36246,72441,4429,4308,4370,4398,4340,4289,26134,63.92%
49826,49449,99275,10235,10180,10096,10256,10277,9902,60946,38.61%
7829,7783,15612,1102,942,1010,1061,1048,963,6126,60.76%
19211,19381,38592,311,333,330,294,293,322,1883,95.12%
35989,35473,71462,4757,4957,4843,4857,4972,4882,29268,59.04%
8469,8357,16826,730,718,759,717,671,719,4314,74.36%
34777,35212,69989,8399,8296,8293,8365,8288,8490,50131,28.37%
15255,15251,30506,3057,2983,2965,3029,2973,3082,18089,40.70%
28434,28148,56582,7257,7178,7224,7226,7142,7041,43068,23.88%
39925,39851,79776,8769,8665,8656,8789,8598,8750,52227,34.53%
10353,10270,20623,2883,2909,2974,2978,2982,2985,17711,14.12%
22432,22167,44599,5764,5823,5654,5672,5858,5720,34491,22.66%
9551,9597,19148,1200,1173,1198,1203,1223,1253,7250,62.14%
35734,35516,71250,6478,6405,6487,6308,6440,6349,38467,46.01%
13491,13385,26876,305,262,292,268,301,290,1718,93.61%
45677,45706,91383,14340,14472,14763,14752,14765,14478,87570,4.17%
6166,6265,12431,1767,1718,1751,1662,1860,1771,10529,15.30%
46003,46299,92302,11820,11783,11708,11660,11795,11935,70701,23.40%
49666,48980,98646,8596,8647,8704,8668,8625,8745,51985,47.30%
8541,8646,17187,2784,2883,2847,2697,2744,2748,16703,2.82%
3417,3437,6854,691,755,763,771,803,851,4634,32.39%
15505,15297,30802,2212,2322,2290,2331,2299,2188,13642,55.71%
10943,11003,21946,3220,3219,3284,3121,3346,3166,19356,11.80%
35682,35780,71462,4552,4586,4444,4492,4482,4608,27164,61.99%
19759,19756,39515,2031,1986,2013,1978,2001,1951,11960,69.73%
29109,29183,58292,9042,9246,9115,9197,8949,9144,54693,6.17%
21719,21779,43498,5744,5686,5748,5794,5845,5677,34494,20.70%
43738,43566,87304,6164,6074,6242,6271,6131,6116,36998,57.62%
24518,24524,49042,5306,5320,5197,5087,5284,5337,31531,35.71%
9218,9166,18384,1247,1267,1246,1288,1255,1233,7536,59.01%
10316,10224,20540,598,578,614,597,614,611,3612,82.41%
24006,23839,47845,4190,4188,4129,4320,4164,4219,25210,47.31%
7611,7813,15424,741,751,798,795,788,817,4690,69.59%
36042,36274,72316,10186,10250,10233,10397,10272,10215,61553,14.88%
21983,21929,43912,7135,7270,7307,7102,7143,7082,43039,1.99%
16055,16354,32409,4778,4617,4681,4661,4649,4564,27950,13.76%
27410,27033,54443,8164,8351,8340,8312,8294,8132,49593,8.91%
42891,43392,86283,3129,3243,3178,3124,3094,3135,18903,78.09%
27560,27597,55157,2493,2374,2411,2428,2401,2462,14569,73.59%
20503,20082,40585,3015,3066,3029,3078,3024,3082,18294,54.92%
8853,9013,17866,3029,2966,2906,2962,2951,3016,17830,0.20%
16902,16681,33583,3988,4010,3892,3990,3946,3992,23818,29.08%
4095,4194,8289,1304,1408,1371,1394,1349,1414,8240,0.59%
15247,14934,30181,2366,2420,2342,2442,2498,2422,14490,51.99%
8041,7897,15938,24,27,25,32,36,22,166,98.96%
38303,38376,76679,5807,5838,5634,5809,5806,5696,34590,54.89%
42035,42104,84139,11311,11424,11641,11406,11343,11474,68599,18.47%
34238,34380,68618,3412,3246,3418,3413,3397,3245,20131,70.66%
45578,45559,91137,3526,3572,3537,3509,3529,3511,21184,76.76%
30727,30293,61020,2349,2364,2326,2282,2336,2269,13926,77.18%
24841,24795,49636,2899,2885,2815,2769,2821,2860,17049,65.65%
19576,19306,38882,4601,4636,4489,4467,4597,4597,27387,29.56%
46992,46726,93718,12125,12070,12048,12073,12141,12135,72592,22.54%
32097,32000,64097,9476,9439,9438,9524,9378,9391,56646,11.62%
32545,32648,65193,77,59,81,63,62,77,419,99.36%
41110,41396,82506,9985,10090,10130,10334,10160,10241,60940,26.14%
45823,45676,91499,329,300,303,290,293,325,1840,97.99%
8561,8447,17008,1743,1660,1779,1804,1709,1723,10418,38.75%
11531,11204,22735,3170,3131,3072,3089,3109,3095,18666,17.90%
3541,3486,7027,1155,1127,1164,1120,1157,1176,6899,1.82%
48530,48326,96856,15067,15080,15136,15040,15163,15072,90558,6.50%
35853,35954,71807,9413,9100,9222,9140,9294,9251,55420,22.82%
7235,7418,14653,1329,1347,1299,1352,1268,1292,7887,46.17%
32813,32518,65331,1037,941,1017,1018,1037,1019,6069,90.71%
4197,4234,8431,286,274,268,304,284,263,1679,80.09%
34781,34619,69400,5427,5487,5631,5477,5485,5526,33033,52.40%
20045,20072,40117,260,271,272,253,293,277,1626,95.95%
38460,38099,76559,2219,2185,2204,2158,2184,2274,13224,82.73%
49702,49956,99658,16415,16508,16236,16636,16291,16259,98345,1.32%
41417,41644,83061,5301,5314,5432,5181,5531,5286,32045,61.42%
24576,24604,49180,1451,1522,1483,1597,1509,1528,9090,81.52%
39120,38677,77797,6045,6084,5896,6074,5960,6193,36252,53.40%
39551,39677,79228,11296,11224,11128,11039,11149,11155,66991,15.45%
5163,5110,10273,1526,1528,1562,1534,1506,1556,9212,10.33%
20861,20924,41785,1142,1222,1082,1210,1158,1122,6936,83.40%
5808,5789,11597,1897,1922,1843,1950,1923,2006,11541,0.48%
33336,33276,66612,7539,7416,7295,7301,7401,7403,44355,33.41%
37405,37142,74547,8298,8330,8353,8274,8219,8372,49846,33.13%
22847,22884,45731,1134,1118,1160,1123,1235,1136,6906,84.90%
6269,6371,12640,184,183,207,182,164,158,1078,91.47%
27378,27670,55048,2916,2927,2844,2961,3015,3019,17682,67.88%
34878,34948,69826,4808,4726,4699,4811,4867,4836,28747,58.83%
22502,22449,44951,4898,4889,4883,4786,4919,5039,29414,34.56%
44158,44381,88539,13549,13345,13249,13398,13327,13445,80313,9.29%
12181,12105,24286,894,895,859,874,870,919,5311,78.13%
22557,22404,44961,5764,5500,5611,5480,5627,5625,33607,25.25%
339,346,685,71,61,74,72,76,71,425,37.96%
45451,45366,90817,2169,2158,2075,2113,2141,2143,12799,85.91%
14450,14515,28965,4898,4726,4816,4836,4780,4815,28871,0.32%
24145,24439,48584,1969,1965,1942,2004,1990,2000,11870,75.57%
44934,45033,89967,12540,12265,12229,12295,12185,12399,73913,17.84%
27089,26753,53842,3807,3842,3883,3808,3817,3816,22973,57.33%
12046,12162,24208,2443,2423,2436,2376,2458,2333,14469,40.23%
27603,27558,55161,5097,5164,5153,5178,5165,5228,30985,43.83%
42226,42329,84555,8832,8833,8722,8881,8932,8735,52935,37.40%
26947,26765,53712,8407,8571,8428,8532,8527,8566,51031,4.99%
7531,7560,15091,362,328,369,342,342,390,2133,85.87%
37088,36623,73711,2213,2152,2133,2116,2165,2131,12910,82.49%
11049,11270,22319,2848,2863,2946,2870,2890,2906,17323,22.38%
13268,13319,26587,3925,3897,4006,3824,3958,3927,23537,11.47%
20658,20592,41250,3718,3568,3545,3689,3690,3797,22007,46.65%
16473,16525,32998,1526,1576,1606,1519,1595,1537,9359,71.64%
25077,25118,50195,630,615,636,612,651,682,3826,92.38%
21151,21155,42306,1269,1332,1335,1353,1257,1223,7769,81.64%
4652,4719,9371,985,1003,999,985,938,935,5845,37.63%
28428,28188,56616,1909,1955,1882,1921,1962,1909,11538,79.62%
8391,8409,16800,2700,2708,2677,2718,2694,2739,16236,3.36%
14255,14189,28444,617,570,602,631,657,638,3715,86.94%
35072,35064,70136,1485,1448,1448,1447,1433,1454,8715,87.57%
6093,6142,12235,1685,1711,1668,1600,1678,1698,10040,17.94%
19332,19413,38745,1077,1100,1114,1135,1078,1032,6536,83.13%
9439,9365,18804,2748,2792,2709,2812,2834,2852,16747,10.94%
11099,11331,22430,1622,1557,1602,1613,1711,1567,9672,56.88%
41715,41891,83606,3376,3404,3480,3360,3394,3464,20478,75.51%
28630,29026,57656,5899,5843,5772,5951,5811,5954,35230,38.90%
27422,27263,54685,2781,2808,2798,2804,2793,2760,16744,69.38%
35015,35002,70017,5583,5673,5548,5673,5598,5687,33762,51.78%
47739,47292,95031,14467,14435,14713,14590,14413,14553,87171,8.27%
39829,39336,79165,11777,11754,11659,11883,11595,11808,70476,10.98%
24538,24724,49262,5030,5214,5011,5040,5089,5020,30404,38.28%
8668,8851,17519,631,624,638,665,617,638,3813,78.24%
16753,16534,33287,205,195,182,204,203,189,1178,96.46%
14702,14607,29309,2550,2492,2401,2569,2505,2622,15139,48.35%
12890,12845,25735,3268,3343,3242,3291,3150,3311,19605,23.82%
44203,44291,88494,10423,10516,10622,10551,10379,10574,63065,28.74%
35139,35430,70569,11269,11385,11104,11222,11050,11162,67192,4.79%
44819,44889,89708,12803,12692,12713,12668,12760,12822,76458,14.77%
10745,10972,21717,2458,2503,2470,2339,2477,2385,14632,32.62%
4141,4201,8342,753,655,720,723,690,789,4330,48.09%
13434,13339,26773,3716,3630,3636,3745,3687,3680,22094,17.48%
21032,20898,41930,5234,5244,5310,5370,5259,5276,31693,24.41%
16862,17122,33984,5333,5464,5460,5307,5304,5306,32174,5.33%
8366,8440,16806,1365,1328,1333,1317,1314,1307,7964,52.61%
29470,29376,58846,483,417,428,444,435,467,2674,95.46%
22516,22348,44864,5812,6033,5884,5872,5862,5962,35425,21.04%
27962,28317,56279,4493,4618,4588,4593,4542,4545,27379,51.35%
548,542,1090,100,99,95,86,107,89,576,47.16%
41031,40886,81917,10619,10591,10483,10309,10446,10310,62758,23.39%
23884,23943,47827,2935,3032,2926,3037,2915,2905,17750,62.89%
44418,44207,88625,1051,1089,1046,1037,1031,1055,6309,92.88%
26095,25438,51533,1915,1916,1962,1944,1895,1959,11591,77.51%
30403,30677,61080,6978,6921,7066,7178,6912,6973,42028,31.19%
36210,36170,72380,8369,8352,8160,8152,8317,8209,49559,31.53%
37319,37576,74895,8079,8202,7988,8262,8195,8150,48876,34.74%
43553,43569,87122,2390,2456,2376,2435,2405,2468,14530,83.32%
6649,6639,13288,357,414,371,385,366,385,2278,82.86%
43512,43765,87277,12189,12109,12165,12212,12129,11914,72718,16.68%
23010,23234,46244,4445,4384,4450,4529,4363,4308,26479,42.74%
17504,17786,35290,1267,1251,1255,1271,1215,1236,7495,78.76%
1227,1193,2420,405,431,388,401,389,404,2418,0.08%
13739,13828,27567,3574,3447,3520,3567,3549,3560,21217,23.03%
1413,1286,2699,48,33,38,26,36,34,215,92.03%
21010,20991,42001,5822,5853,5817,5792,5684,5655,34623,17.57%
6341,6359,12700,316,284,313,304,286,348,1851,85.43%
39331,39001,78332,11395,11534,11349,11319,11542,11585,68724,12.27%
11451,11424,22875,1100,1115,1075,1083,1068,1217,6658,70.89%
32844,32324,65168,2701,2748,2718,2671,2638,2728,16204,75.14%
43632,43575,87207,6002,6237,6096,6048,5855,6002,36240,58.44%
4718,4722,9440,1485,1475,1510,1455,1497,1466,8888,5.85%
9390,9261,18651,2477,2530,2640,2666,2517,2656,15486,16.97%
5803,5846,11649,1767,1797,1837,1837,1827,1776,10841,6.94%
21964,21968,43932,6994,6865,6757,6861,6878,6901,41256,6.09%
25213,24839,50052,33,31,42,34,38,38,216,99.57%
12347,12303,24650,2039,1896,1927,1938,1952,1962,11714,52.48%
1335,1280,2615,33,42,50,64,54,45,288,88.99%
9434,9658,19092,458,428,417,452,388,451,2594,86.41%
29204,28864,58068,3411,3400,3500,3424,3358,3455,20548,64.61%
6049,5958,12007,1121,1121,1042,1072,1072,1078,6506,45.81%
40436,40718,81154,5526,5434,5536,5566,5480,5534,33076,59.24%
29427,29400,58827,7127,7207,7156,7151,7257,7273,43171,26.61%
32024,32057,64081,4489,4561,4458,4541,4540,4488,27077,57.75%
34004,34031,68035,10873,10699,10489,10652,10821,10734,64268,5.54%
18224,18355,36579,2993,2898,2991,3025,3090,3118,18115,50.48%
25037,25099,50136,250,226,217,222,225,191,1331,97.35%
45002,44635,89637,12863,13050,12842,12931,12806,12708,77200,13.87%
49487,49037,98524,5594,5454,5497,5529,5282,5412,32768,66.74%
17403,17433,34836,815,827,802,823,800,788,4855,86.06%
39571,39394,78965,3926,4046,3871,3866,3802,3904,23415,70.35%
35153,35189,70342,4352,4335,4354,4373,4432,4402,26248,62.69%
32434,32201,64635,4372,4339,4368,4362,4374,4260,26075,59.66%
22858,22697,45555,6669,6644,6794,6656,6902,6629,40294,11.55%
27828,27989,55817,565,570,589,550,609,619,3502,93.73%
20413,20535,40948,6313,6388,6573,6419,6628,6387,38708,5.47%
23337,23225,46562,3504,3410,3330,3297,3316,3370,20227,56.56%
4027,4047,8074,169,140,154,147,154,176,940,88.36%
30654,30617,61271,3633,3781,3677,3822,3753,3742,22408,63.43%
35107,35241,70348,11549,11670,11804,11730,11566,11423,69742,0.86%
33189,33038,66227,2738,2812,2708,2679,2768,2754,16459,75.15%
45928,46013,91941,9458,9344,9239,9555,9519,9368,56483,38.57%
21613,21596,43209,2142,2090,2159,2164,2037,2133,12725,70.55%
27316,27179,54495,2376,2482,2410,2288,2346,2363,14265,73.82%
32502,33006,65508,7106,7067,7003,6889,7097,6876,42038,35.83%
31361,31772,63133,4226,4295,4301,4295,4310,4335,25762,59.19%
47311,46908,94219,8654,8797,8797,8653,8737,8855,52493,44.29%
29385,29309,58694,3044,3009,2990,3047,3028,3035,18153,69.07%
6051,6013,12064,401,422,423,421,420,426,2513,79.17%
38500,38508,77008,12498,12469,12715,12785,12642,12420,75529,1.92%
14954,15023,29977,3114,3161,3146,3152,3138,3173,18884,37.01%
22257,22284,44541,2312,2373,2353,2381,2343,2340,14102,68.34%
29275,29048,58323,518,513,543,482,544,499,3099,94.69%
38751,39032,77783,10911,10725,10834,11017,10827,10849,65163,16.22%
46774,47355,94129,14731,14485,14522,14474,14769,14714,87695,6.84%
20837,21052,41889,6888,6856,7001,7007,7064,6964,41780,0.26%
30967,30990,61957,6653,6494,6535,6411,6485,6465,39043,36.98%
4599,4703,9302,1303,1250,1262,1238,1362,1264,7679,17.45%
34834,35113,69947,5753,5877,5911,5805,5717,5822,34885,50.13%
35393,35367,70760,5227,5263,5269,5179,5255,5273,31466,55.53%
39288,39357,78645,10957,10788,10976,10989,11030,10939,65679,16.49%
27174,27377,54551,3452,3545,3565,3693,3540,3481,21276,61.00%
12058,12316,24374,3794,3893,3817,3895,3893,3851,23143,5.05%
25349,25531,50880,2801,2697,2727,2838,2733,2840,16636,67.30%
908,915,1823,49,44,37,39,40,47,256,85.96%
9854,9716,19570,169,134,135,156,148,145,887,95.47%
42493,42237,84730,8614,8708,8569,8419,8624,8672,51606,39.09%
5974,6032,12006,245,224,227,239,197,231,1363,88.65%
27433,27733,55166,4685,4682,4611,4725,4675,4692,28070,49.12%
12426,12297,24723,2360,2316,2295,2326,2424,2351,14072,43.08%
38015,37770,75785,12170,12109,11998,11886,12060,12056,72279,4.63%
37870,37830,75700,5746,5610,5687,5706,5712,5626,34087,54.97%
6347,6187,12534,706,730,714,752,769,729,4400,64.90%
48633,48490,97123,13152,13293,13364,13368,13297,13308,79782,17.85%
15716,15678,31394,2402,2537,2364,2406,2341,2408,14458,53.95%
27468,27290,54758,2453,2510,2421,2479,2468,2367,14698,73.16%
42775,42833,85608,6463,6309,6363,6409,6469,6432,38445,55.09%
17999,17971,35970,875,893,896,908,896,854,5322,85.20%
10775,10637,21412,366,357,373,376,362,363,2197,89.74%
33463,33827,67290,7481,7466,7459,7509,7509,7484,44908,33.26%
28729,28553,57282,3145,3328,3301,3303,3287,3402,19766,65.49%
9939,10012,19951,2912,2893,2946,2918,2898,2899,17466,12.46%
2966,2944,5910,964,891,921,911,930,940,5557,5.97%
26613,26743,53356,3209,3201,3167,3048,3073,3010,18708,64.94%
36420,36699,73119,8932,8895,8901,8872,9037,8943,53580,26.72%
32096,31988,64084,3283,3343,3478,3345,3335,3341,20125,68.60%
496,514,1010,162,165,168,154,181,160,990,1.98%
26214,25950,52164,3122,3028,3090,3175,3105,3177,18697,64.16%
42383,42848,85231,8958,9106,8881,8939,8883,8938,53705,36.99%
16743,17117,33860,4401,4395,4520,4421,4358,4405,26500,21.74%
21888,22057,43945,5132,5046,5064,4930,5028,5018,30218,31.24%
34269,34487,68756,722,724,689,727,693,707,4262,93.80%
34409,34230,68639,2441,2432,2452,2377,2419,2526,14647,78.66%
38297,38275,76572,3493,3495,3531,3459,3524,3521,21023,72.54%
12938,12843,25781,2227,2325,2276,2282,2276,2250,13636,47.11%
1939,1868,3807,246,253,214,277,248,235,1473,61.31%
1928,1925,3853,373,350,340,375,344,332,2114,45.13%
3304,3245,6549,92,111,115,106,114,103,641,90.21%
38976,38929,77905,9846,9865,9763,10044,9832,9901,59251,23.94%
1221,1192,2413,294,335,307,304,292,269,1801,25.36%
36177,36198,72375,1043,1022,1012,1005,1069,1060,6211,91.42%
36294,36307,72601,6159,6312,6203,6244,6094,6134,37146,48.84%
6260,6486,12746,719,731,660,632,712,714,4168,67.30%
15878,15955,31833,3423,3446,3394,3457,3366,3439,20525,35.52%
30639,30431,61070,6648,6747,6715,6653,6822,6794,40379,33.88%
43432,43787,87219,1624,1673,1603,1696,1655,1669,9920,88.63%
16485,16357,32842,104,106,116,115,126,126,693,97.89%
25563,25369,50932,1812,1728,1723,1711,1693,1713,10380,79.62%
5685,5738,11423,464,429,440,455,415,451,2654,76.77%
9136,9152,18288,2073,2086,2099,2181,2135,2157,12731,30.39%
4300,4283,8583,695,613,629,620,671,636,3864,54.98%
30626,30538,61164,165,167,133,156,144,137,902,98.53%
12360,12375,24735,114,122,104,102,107,104,653,97.36%
47751,48291,96042,11226,11128,11042,11093,10982,11081,66552,30.71%
12341,12384,24725,929,907,977,912,946,928,5599,77.35%
29740,29422,59162,2012,1961,1995,2072,2047,2045,12132,79.49%
17053,16954,34007,4187,4068,4079,3996,4060,4126,24516,27.91%
20128,19729,39857,5944,5802,5822,5912,5655,5741,34876,12.50%
26320,26462,52782,622,612,586,577,577,624,3598,93.18%
24270,24268,48538,1856,1788,1843,1746,1817,1807,10857,77.63%
21164,20997,42161,4935,4995,4863,4847,4823,4961,29424,30.21%
31689,31673,63362,2937,2967,3009,2931,2896,3002,17742,72.00%
48007,48085,96092,10893,11071,11249,11140,11050,11032,66435,30.86%
6524,6472,12996,602,619,604,583,583,658,3649,71.92%
44107,44052,88159,3806,3966,3790,3811,3840,3796,23009,73.90%
8338,8219,16557,1794,1857,1849,1855,1854,1914,11123,32.82%
45068,45027,90095,4517,4345,4464,4463,4335,4361,26485,70.60%
5658,5559,11217,349,335,330,351,332,348,2045,81.77%
28330,28422,56752,1879,1827,1800,1735,1802,1810,10853,80.88%
33539,33431,66970,9859,9741,9842,9906,9604,9665,58617,12.47%
38947,39001,77948,3438,3446,3497,3489,3481,3494,20845,73.26%
18345,18065,36410,4093,4045,4051,4119,4147,4188,24643,32.32%
40225,40254,80479,2821,2701,2721,2674,2797,2755,16469,79.54%
33870,33776,67646,2401,2419,2456,2304,2460,2341,14381,78.74%
15154,15323,30477,490,580,493,502,519,524,3108,89.80%
20009,19866,39875,3585,3478,3550,3472,3529,3642,21256,46.69%
9347,9241,18588,2450,2324,2357,2362,2333,2316,14142,23.92%
34427,34146,68573,7731,7717,7710,7762,7618,7622,46160,32.68%
17576,17469,35045,4425,4358,4441,4419,4409,4398,26450,24.53%
19052,19041,38093,1826,1895,1909,1950,1831,1828,11239,70.50%
14308,14333,28641,2920,2973,3016,2847,2962,2912,17630,38.44%
27108,26853,53961,7898,7980,7813,7869,7735,7870,47165,12.59%
7766,7732,15498,1164,1190,1205,1158,1143,1163,7023,54.68%
6146,6172,12318,730,687,764,735,782,686,4384,64.41%
29931,30108,60039,2209,2169,2234,2206,2245,2233,13296,77.85%
22572,22799,45371,6369,6455,6527,6450,6552,6353,38706,14.69%
43446,43243,86689,10577,10604,10779,10602,10506,10458,63526,26.72%
100,94,194,8,16,9,20,19,18,90,53.61%
30446,30580,61026,7301,7162,7211,7155,7204,7259,43292,29.06%
15934,15834,31768,337,337,319,345,360,296,1994,93.72%
14365,14112,28477,1888,1957,1910,1918,1976,1981,11630,59.16%
21781,21893,43674,4939,4909,4807,4935,5080,4851,29521,32.41%
24490,24463,48953,3214,3179,3053,3163,3146,3130,18885,61.42%
33678,33764,67442,3819,3749,3934,3879,3799,3822,23002,65.89%
21822,21860,43682,1803,1801,1743,1787,1807,1794,10735,75.42%
24290,24112,48402,1057,952,976,993,1037,1016,6031,87.54%
40956,41215,82171,1263,1298,1316,1309,1264,1302,7752,90.57%
45478,45658,91136,14117,14324,13965,14235,14191,14058,84890,6.85%
21194,21009,42203,2163,2187,2140,2210,2176,2290,13166,68.80%
4271,4300,8571,91,64,71,72,80,74,452,94.73%
24483,24324,48807,6245,6246,6175,6319,6405,6253,37643,22.87%
18846,19007,37853,6145,6122,6135,5972,6274,6180,36828,2.71%
85,91,176,19,23,23,28,28,29,150,14.77%
4627,4701,9328,1044,1042,1068,1137,1109,1126,6526,30.04%
15665,15775,31440,3291,3336,3293,3291,3281,3244,19736,37.23%
17373,17479,34852,267,212,219,234,221,261,1414,95.94%
28849,28996,57845,7278,7456,7421,7409,7397,7171,44132,23.71%
40734,40824,81558,10947,10987,11038,11129,10937,11043,66081,18.98%
38858,38910,77768,2622,2690,2723,2685,2665,2625,16010,79.41%
45947,46200,92147,8953,9060,8969,9098,8964,9011,54055,41.34%
14187,14080,28267,479,449,456,492,511,468,2855,89.90%
30292,30404,60696,9922,9992,9816,9840,9861,9944,59375,2.18%
17537,17399,34936,787,804,840,837,824,759,4851,86.11%
20127,20442,40569,4753,4653,4726,4639,4634,4590,27995,30.99%
41289,40867,82156,3976,3950,4088,4042,4048,4075,24179,70.57%
8397,8166,16563,414,405,412,426,424,415,2496,84.93%
3157,3252,6409,410,449,404,426,411,436,2536,60.43%
33615,33404,67019,5508,5751,5502,5513,5580,5482,33336,50.26%
26755,26493,53248,8718,8410,8485,8584,8416,8623,51236,3.78%
40484,40581,81065,7425,7456,7339,7406,7383,7314,44323,45.32%
3929,3977,7906,402,445,405,448,451,427,2578,67.39%
31401,31970,63371,1441,1458,1477,1445,1425,1473,8719,86.24%
27997,27859,55856,1341,1343,1298,1322,1315,1321,7940,85.78%
7616,7686,15302,266,267,261,261,250,268,1573,89.72%
1604,1644,3248,389,378,348,386,371,386,2258,30.48%
14827,14680,29507,220,262,256,269,245,261,1513,94.87%
25434,25305,50739,8565,8395,8406,8412,8428,8469,50675,0.13%
38162,38406,76568,7259,7397,7335,7489,7445,7313,44238,42.22%
9903,9887,19790,742,666,669,722,725,732,4256,78.49%
13653,13863,27516,3115,3106,3145,3115,3101,3069,18651,32.22%
32146,32101,64247,2906,2971,2922,2850,2959,2814,17422,72.88%
5619,5723,11342,657,631,632,679,638,638,3875,65.83%
5769,5736,11505,1882,1918,1926,1920,1896,1950,11492,0.11%
44396,44532,88928,8347,8197,8392,8298,8190,8395,49819,43.98%
33678,33427,67105,6987,7091,7185,6969,7128,7198,42558,36.58%
1299,1364,2663,361,341,384,350,393,351,2180,18.14%
9740,9667,19407,1151,1176,1144,1068,1122,1083,6744,65.25%
14003,14040,28043,2341,2293,2230,2209,2243,2316,13632,51.39%
11404,11206,22610,819,830,888,922,831,841,5131,77.31%
44422,44617,89039,13603,13445,13594,13518,13286,13383,80829,9.22%
44197,44110,88307,8860,8815,8960,8798,8647,8827,52907,40.09%
17088,17183,34271,4950,4895,4820,4893,4912,4949,29419,14.16%
48288,48398,96686,2784,2823,2802,2765,2737,2766,16677,82.75%
12280,12154,24434,1153,1137,1236,1187,1201,1203,7117,70.87%
33212,33397,66609,3869,3980,3954,3967,4065,3983,23818,64.24%
6054,6127,12181,1961,2031,1925,1962,1952,1937,11768,3.39%
4276,4286,8562,641,602,603,589,609,581,3625,57.66%
38277,38436,76713,4964,5108,4947,5107,5089,4893,30108,60.75%
8156,8043,16199,2554,2654,2668,2607,2472,2568,15523,4.17%
791,805,1596,202,185,227,194,177,190,1175,26.38%
11933,11969,23902,3507,3715,3556,3614,3640,3583,21615,9.57%
36886,37092,73978,11639,11771,11815,11788,11810,11889,70712,4.41%
39094,38938,78032,4409,4374,4497,4577,4529,4494,26880,65.55%
45,77,122,0,3,3,1,4,4,15,87.70%
38623,38550,77173,5298,5303,5336,5404,5346,5317,32004,58.53%
28551,28542,57093,7499,7381,7411,7195,7146,7442,44074,22.80%
28775,29035,57810,8735,8377,8536,8637,8613,8617,51515,10.89%
20765,20950,41715,1035,1108,1060,1095,1122,1053,6473,84.48%
25773,25835,51608,5967,5969,5890,5875,5852,5971,35524,31.17%
16378,16457,32835,737,658,758,747,714,729,4343,86.77%
45260,45418,90678,2286,2354,2217,2304,2283,2330,13774,84.81%
11408,11514,22922,1646,1643,1553,1567,1592,1567,9568,58.26%
44342,44923,89265,400,393,397,415,424,426,2455,97.25%
26538,26204,52742,5718,5603,5590,5619,5649,5578,33757,36.00%
47009,46549,93558,2095,2074,2024,2177,2112,2083,12565,86.57%
31387,31141,62528,5732,5652,5874,5823,5766,5886,34733,44.45%
22701,22451,45152,5381,5555,5474,5487,5577,5632,33106,26.68%
27283,27227,54510,5234,5357,5381,5222,5223,5414,31831,41.61%
43528,43560,87088,5069,4939,5232,5067,5054,5106,30467,65.02%
26388,26424,52812,7944,8205,8114,8081,7967,8228,48539,8.09%
324,327,651,50,46,35,33,47,50,261,59.91%
14994,14759,29753,4223,4230,4296,4261,4209,4361,25580,14.03%
5306,5402,10708,1018,1029,1014,1019,1008,1011,6099,43.04%
36427,36009,72436,1735,1737,1689,1710,1727,1782,10380,85.67%
47329,47278,94607,11703,11935,11933,11792,11531,11712,70606,25.37%
42552,42254,84806,11061,11171,11029,11104,11123,10988,66476,21.61%
8203,8107,16310,655,669,658,708,681,686,4057,75.13%
38628,38403,77031,4364,4369,4337,4308,4473,4382,26233,65.94%
13803,13687,27490,340,356,338,346,345,333,2058,92.51%
28569,28867,57436,7605,7578,7568,7633,7576,7675,45635,20.55%
48627,48637,97264,11524,11416,11427,11693,11613,11703,69376,28.67%
45318,45220,90538,2508,2424,2449,2421,2470,2444,14716,83.75%
48715,48560,97275,14538,14764,14646,14619,14834,14879,88280,9.25%
3975,3937,7912,1268,1200,1289,1267,1273,1268,7565,4.39%
32845,33163,66008,2722,2753,2698,2737,2686,2633,16229,75.41%
2510,2544,5054,705,713,652,683,700,705,4158,17.73%
25010,24944,49954,1147,1214,1170,1130,1166,1094,6921,86.15%
2333,2341,4674,525,531,507,508,470,528,3069,34.34%
37310,37914,75224,10290,10480,10295,10232,10432,10303,62032,17.54%
34299,34413,68712,4173,4083,4148,4176,3991,4110,24681,64.08%
24741,25019,49760,2262,2455,2330,2310,2315,2319,13991,71.88%
31667,32300,63967,2990,2934,3019,2905,3012,2937,17797,72.18%
1268,1320,2588,403,373,387,374,368,399,2304,10.97%
25027,24773,49800,3726,3794,3741,3755,3776,3773,22565,54.69%
15199,15252,30451,3682,3820,3672,3734,3629,3676,22213,27.05%
20685,20995,41680,1366,1382,1348,1335,1361,1379,8171,80.40%
31442,31401,62843,4902,4959,4903,4921,4954,5117,29756,52.65%
8357,8227,16584,1924,1937,1928,1924,1920,1973,11606,30.02%
5563,5401,10964,906,958,920,914,962,940,5600,48.92%
35813,35824,71637,9324,9315,9167,9330,9362,9417,55915,21.95%
42418,42446,84864,454,410,401,391,404,414,2474,97.08%
41427,41608,83035,1987,2011,2061,2045,2016,1965,12085,85.45%
22279,22031,44310,2618,2679,2670,2622,2634,2570,15793,64.36%
33156,33548,66704,9208,9438,9157,9227,9430,9312,55772,16.39%
45370,45027,90397,5604,5580,5615,5629,5647,5579,33654,62.77%
11106,10996,22102,1291,1177,1215,1235,1215,1195,7328,66.84%
32326,31810,64136,870,900,914,914,894,900,5392,91.59%
27847,27257,55104,5526,5519,5648,5538,5592,5703,33526,39.16%
2040,1970,4010,551,538,548,514,579,523,3253,18.88%
40787,40870,81657,13428,13679,13566,13588,13467,13682,81410,0.30%
13421,13369,26790,3434,3468,3367,3445,3433,3481,20628,23.00%
7303,7370,14673,897,955,924,907,945,907,5535,62.28%
39095,39429,78524,6527,6485,6616,6460,6524,6504,39116,50.19%
40482,40236,80718,5728,5643,5687,5659,5430,5684,33831,58.09%
33442,33497,66939,10098,10258,10304,10033,10120,10123,60936,8.97%
38973,38929,77902,3077,2922,2966,2972,2954,2998,17889,77.04%
8893,8829,17722,2023,2027,2054,2050,2018,1990,12162,31.37%
33533,33490,67023,5473,5492,5425,5429,5577,5625,33021,50.73%
23616,23635,47251,1380,1316,1378,1359,1368,1403,8204,82.64%
45432,45409,90841,7301,7283,7195,6993,7083,7121,42976,52.69%
19457,19451,38908,2989,3063,3060,3115,3068,2972,18267,53.05%
27951,28215,56166,6650,6590,6601,6662,6569,6614,39686,29.34%
9897,9992,19889,221,248,255,229,222,225,1400,92.96%
28503,28828,57331,7486,7613,7640,7576,7664,7517,45496,20.64%
21844,21881,43725,5726,5650,5630,5437,5491,5743,33677,22.98%
23968,24021,47989,7520,7425,7346,7477,7399,7655,44822,6.60%
14654,14710,29364,3536,3509,3442,3600,3439,3528,21054,28.30%
26806,26875,53681,4767,4633,4764,4770,4800,4786,28520,46.87%
31468,31600,63068,9189,9182,9053,9059,9009,9004,54496,13.59%
33903,34019,67922,4231,4214,4205,4125,4196,4161,25132,63.00%
47799,47880,95679,13812,14011,14099,13807,13972,13977,83678,12.54%
7852,7838,15690,1889,1845,1865,1871,1879,1897,11246,28.32%
2458,2516,4974,281,322,300,312,294,309,1818,63.45%
1743,1700,3443,463,480,496,459,436,447,2781,19.23%
22949,22776,45725,3000,2978,3001,3018,2966,2997,17960,60.72%
29525,29499,59024,2911,2862,2784,2966,2867,2837,17227,70.81%
48634,48916,97550,473,485,504,483,495,489,2929,97.00%
38162,38136,76298,2958,2966,2948,3029,2956,2960,17817,76.65%
9389,9483,18872,2831,2755,2806,2725,2791,2884,16792,11.02%
801,792,1593,106,107,112,93,97,97,612,61.58%
8032,8218,16250,1897,1870,1934,1897,1920,1907,11425,29.69%
41889,41852,83741,11472,11362,11247,11625,11626,11352,68684,17.98%
21887,21980,43867,1034,1061,1052,1068,1020,974,6209,85.85%
44835,44503,89338,52,48,41,54,50,43,288,99.68%
31313,31422,62735,398,367,381,407,422,412,2387,96.20%
12201,12440,24641,3761,3926,3769,3872,3728,3781,22837,7.32%
25558,25552,51110,1753,1673,1660,1652,1699,1706,10143,80.15%
1602,1584,3186,336,344,319,366,347,342,2054,35.53%
20688,20773,41461,689,692,695,668,748,682,4174,89.93%
10363,10720,21083,25,31,16,23,22,22,139,99.34%
43616,43747,87363,6956,6874,6998,6871,6918,6955,41572,52.41%
5315,5248,10563,1076,1076,1098,1060,1062,1063,6435,39.08%
46627,46474,93101,2611,2527,2563,2655,2572,2592,15520,83.33%
40532,40304,80836,8350,8262,8316,8419,8292,8473,50112,38.01%
19475,19543,39018,4290,4218,4137,4232,4157,4097,25131,35.59%
8798,8797,17595,978,952,895,938,931,928,5622,68.05%
15308,15437,30745,1556,1524,1622,1625,1550,1572,9449,69.27%
13979,14102,28081,3586,3619,3599,3555,3752,3641,21752,22.54%
1742,1740,3482,93,95,97,107,103,98,593,82.97%
38455,38515,76970,9185,9297,9048,9189,9111,8924,54754,28.86%
43959,43818,87777,6142,6333,6358,6287,6365,6211,37696,57.05%
15405,15334,30739,1575,1576,1666,1684,1706,1689,9896,67.81%
13972,13903,27875,2037,2102,2016,1993,2018,2049,12215,56.18%
40560,40953,81513,12091,11890,11810,11895,11721,11821,71228,12.62%
9813,9920,19733,2732,2805,2591,2765,2706,2834,16433,16.72%
6127,6320,12447,130,112,133,144,138,128,785,93.69%
4571,4392,8963,1402,1394,1396,1422,1352,1355,8321,7.16%
9024,9026,18050,2561,2654,2627,2715,2600,2540,15697,13.04%
11527,11616,23143,3091,3188,3058,3097,3060,3067,18561,19.80%
24866,24514,49380,6364,6241,6342,6325,6396,6353,38021,23.00%
32569,32649,65218,10729,10495,10653,10735,10578,10462,63652,2.40%
21977,21969,43946,2098,2199,2159,2043,2035,2149,12683,71.14%
1763,1684,3447,239,243,210,207,214,222,1335,61.27%
16739,17015,33754,3477,3491,3526,3498,3543,3448,20983,37.84%
9539,9729,19268,317,327,330,308,299,294,1875,90.27%
3447,3505,6952,197,192,185,195,209,192,1170,83.17%
12138,12320,24458,4028,3957,4034,4030,3919,4008,23976,1.97%
12886,13109,25995,1621,1581,1576,1665,1705,1616,9764,62.44%
14481,14558,29039,1595,1519,1616,1604,1563,1595,9492,67.31%
28034,27794,55828,1648,1700,1683,1623,1714,1693,10061,81.98%
6409,6331,12740,110,104,108,113,123,106,664,94.79%
8756,8543,17299,2649,2679,2624,2754,2694,2693,16093,6.97%
45018,45493,90511,10131,9974,10030,10038,9811,10190,60174,33.52%
35580,35314,70894,6991,6965,7140,7015,6949,6984,42044,40.69%
27120,27052,54172,561,546,559,546,559,556,3327,93.86%
11367,11582,22949,2255,2308,2260,2357,2287,2355,13822,39.77%
8647,8812,17459,1223,1246,1284,1274,1261,1275,7563,56.68%
2630,2519,5149,220,234,252,255,216,236,1413,72.56%
4429,4371,8800,1141,1150,1080,1259,1185,1126,6941,21.12%
29851,30217,60068,6967,6844,6792,6590,6996,6805,40994,31.75%
40727,40536,81263,12891,12851,12727,12754,12770,12675,76668,5.65%
36688,36837,73525,2376,2317,2280,2293,2272,2241,13779,81.26%
24360,24608,48968,4397,4239,4343,4282,4410,4470,26141,46.62%
19222,18968,38190,3495,3548,3541,3452,3499,3512,21047,44.89%
49364,49490,98854,14023,14273,14130,14077,14227,13933,84663,14.36%
47594,47118,94712,7505,7386,7569,7629,7659,7375,45123,52.36%
41768,42038,83806,12887,12857,12975,12926,12956,12918,77519,7.50%
16996,17165,34161,2149,2238,2179,2179,2268,2399,13412,60.74%
16604,16534,33138,3469,3448,3495,3414,3430,3476,20732,37.44%
27945,27781,55726,546,543,548,553,584,584,3358,93.97%
5696,5651,11347,595,621,606,647,576,616,3661,67.74%
3244,3226,6470,637,694,689,676,701,673,4070,37.09%
21994,21933,43927,3438,3323,3451,3350,3359,3398,20319,53.74%
13609,13629,27238,3174,3248,3296,3270,3289,3198,19475,28.50%
36126,35700,71826,9891,9754,9817,9795,9604,9828,58689,18.29%
11902,11863,23765,2386,2337,2362,2422,2410,2396,14313,39.77%
24591,24835,49426,3681,3602,3740,3673,3627,3671,21994,55.50%
26159,26010,52169,7660,7574,7569,7499,7667,7778,45747,12.31%
3013,2919,5932,830,902,877,863,901,848,5221,11.99%
2320,2259,4579,139,142,155,160,159,154,909,80.15%
1944,1863,3807,438,427,432,443,431,461,2632,30.86%
20785,20924,41709,3788,3773,3729,3707,3741,3701,22439,46.20%
48694,48656,97350,11510,11533,11569,11548,11519,11469,69148,28.97%
22952,22961,45913,6710,6666,6813,6772,6769,6748,40478,11.84%
9897,10136,20033,2320,2361,2380,2355,2398,2375,14189,29.17%
50045,49522,99567,8536,8546,8534,8688,8503,8551,51358,48.42%
1247,1273,2520,126,152,135,111,135,131,790,68.65%
9445,9473,18918,2431,2546,2556,2575,2509,2468,15085,20.26%
17506,17493,34999,307,323,303,314,307,302,1856,94.70%
7037,7067,14104,268,219,247,222,224,244,1424,89.90%
4035,3943,7978,931,909,974,907,941,928,5590,29.93%
25112,25108,50220,7361,7276,7396,7290,7329,7512,44164,12.06%
29166,29365,58531,1411,1395,1491,1418,1420,1432,8567,85.36%
279,304,583,56,60,76,67,64,74,397,31.90%
31217,31123,62340,5314,5230,5417,5318,5294,5119,31692,49.16%
27680,27722,55402,2677,2575,2611,2673,2683,2653,15872,71.35%
10160,9976,20136,381,411,383,391,389,419,2374,88.21%
34149,33995,68144,5232,5453,5298,5245,5448,5302,31978,53.07%
2168,2147,4315,294,255,280,261,290,278,1658,61.58%
32539,32181,64720,7881,7779,7815,7706,7865,7769,46815,27.67%
23081,23399,46480,6566,6642,6655,6677,6528,6736,39804,14.36%
9539,9548,19087,146,150,153,165,133,157,904,95.26%
33922,34032,67954,6081,5960,5979,6094,5977,6050,36141,46.82%
26320,26354,52674,3660,3660,3776,3590,3680,3653,22019,58.20%
48725,49238,97963,12900,13188,12920,12963,13140,13014,78125,20.25%
48010,48145,96155,8192,8019,8103,8091,7976,8108,48489,49.57%
1012,995,2007,187,216,210,210,209,212,1244,38.02%
34350,34031,68381,4862,4833,4839,4961,4963,5005,29463,56.91%
31305,31363,62668,9773,9602,9820,9916,9836,9875,58822,6.14%
48673,49222,97895,4932,5038,4981,5073,4912,4968,29904,69.45%
45036,45367,90403,7142,7041,7123,7001,7099,7046,42452,53.04%
14384,14238,28622,2589,2484,2658,2519,2575,2427,15252,46.71%
22521,22875,45396,3883,3812,3820,3802,3842,3870,23029,49.27%
12414,12680,25094,2159,2124,2147,2155,2158,2271,13014,48.14%
26741,27098,53839,502,538,478,535,515,513,3081,94.28%
3271,3305,6576,236,251,235,240,294,244,1500,77.19%
96,87,183,24,16,14,10,10,24,98,46.45%
32895,33089,65984,9402,9331,9346,9281,9419,9489,56268,14.72%
11044,10963,22007,1857,1970,1906,1949,1864,2012,11558,47.48%
30041,30249,60290,536,462,438,517,474,508,2935,95.13%
40000,39723,79723,1870,1936,1897,1921,1837,1864,11325,85.79%
22614,22702,45316,4198,4202,4260,4273,4385,4238,25556,43.60%
33879,33668,67547,3347,3350,3438,3375,3441,3371,20322,69.91%
45404,45646,91050,13654,13300,13628,13525,13678,13544,81329,10.68%
19849,19770,39619,5639,5453,5576,5527,5591,5470,33256,16.06%
36866,36827,73693,8422,8488,8523,8494,8500,8605,51032,30.75%
38600,38553,77153,8616,8292,8547,8685,8746,8561,51447,33.32%
28755,28671,57426,5188,5164,5204,5285,5295,5123,31259,45.57%
35981,36408,72389,10311,10267,10177,10242,10272,10316,61585,14.92%
29163,28978,58141,7746,7913,7746,7850,7930,7800,46985,19.19%
690,682,1372,21,15,8,15,10,15,84,93.88%
40919,40609,81528,9084,8957,9194,9111,9245,9023,54614,33.01%
40235,40511,80746,2639,2642,2616,2545,2510,2612,15564,80.72%
14828,14966,29794,4504,4424,4531,4472,4451,4472,26854,9.87%
26769,27313,54082,3338,3378,3331,3339,3350,3426,20162,62.72%
25948,26237,52185,4395,4355,4421,4340,4289,4315,26115,49.96%
971,984,1955,152,127,136,110,120,127,772,60.51%
3573,3652,7225,20,20,26,35,16,23,140,98.06%
20813,20804,41617,3675,3703,3655,3660,3699,3661,22053,47.01%
37921,37307,75228,8512,8353,8132,8251,8214,8365,49827,33.77%
3397,3300,6697,972,976,1036,971,1013,988,5956,11.06%
7575,7609,15184,182,227,211,190,172,203,1185,92.20%
21458,21706,43164,3682,3507,3480,3548,3591,3588,21396,50.43%
42933,43143,86076,6277,6231,6105,6220,6254,6365,37452,56.49%
4365,4332,8697,666,619,602,588,634,636,3745,56.94%
37909,37680,75589,8267,8116,8264,8172,8132,8105,49056,35.10%
2106,2256,4362,667,687,662,665,677,699,4057,6.99%
22701,22215,44916,6455,6459,6442,6452,6670,6599,39077,13.00%
8816,8713,17529,1572,1476,1472,1581,1518,1441,9060,48.31%
9468,9696,19164,49,49,55,46,57,46,302,98.42%
34421,34214,68635,9623,9355,9566,9528,9632,9352,57056,16.87%
4070,4044,8114,286,295,262,266,278,289,1676,79.34%
1056,1078,2134,329,322,331,321,321,315,1939,9.14%
44955,44920,89875,3123,3145,3151,3198,3024,3105,18746,79.14%
26395,26402,52797,5651,5843,5605,5724,5753,5778,34354,34.93%
31014,30971,61985,5182,5296,5098,5235,5193,5190,31194,49.67%
43097,43186,86283,1037,1059,1052,1077,1085,1092,6402,92.58%
23631,23800,47431,1632,1688,1623,1669,1594,1627,9833,79.27%
24611,25031,49642,1328,1399,1328,1294,1310,1405,8064,83.76%
18777,18758,37535,4371,4327,4303,4328,4465,4301,26095,30.48%
3577,3511,7088,571,565,523,503,573,577,3312,53.27%
38131,38426,76557,1322,1298,1402,1369,1312,1331,8034,89.51%
8560,8653,17213,858,840,816,875,858,874,5121,70.25%
24692,24557,49249,836,859,851,846,868,891,5151,89.54%
12537,12751,25288,4261,4122,4211,4171,4138,4208,25111,0.70%
18031,17900,35931,4314,4402,4217,4167,4280,4228,25608,28.73%
32304,32533,64837,6867,6819,6696,6732,6712,6755,40581,37.41%
5149,5148,10297,1234,1319,1272,1342,1382,1279,7828,23.98%
22997,22906,45903,2558,2566,2542,2484,2539,2549,15238,66.80%
35220,35373,70593,2576,2665,2700,2551,2642,2535,15669,77.80%
22038,21798,43836,7022,6955,6998,6817,7035,6899,41726,4.81%
3145,3358,6503,1000,1030,1018,982,994,982,6006,7.64%
23878,23772,47650,6,3,6,3,8,3,29,99.94%
16208,16319,32527,5385,5280,5456,5539,5352,5269,32281,0.76%
20647,20794,41441,5316,5370,5308,5411,5365,5236,32006,22.77%
25794,25811,51605,3636,3606,3501,3545,3489,3587,21364,58.60%
39496,39394,78890,7830,7833,7853,7661,7704,7767,46648,40.87%
17201,17210,34411,936,940,925,918,961,918,5598,83.73%
25988,26106,52094,3182,3212,3229,3231,3204,3275,19333,62.89%
28540,28521,57061,3424,3376,3253,3435,3401,3417,20306,64.41%
41510,41198,82708,10062,10118,10182,10307,10184,10019,60872,26.40%
46907,47289,94196,9149,9202,9006,9134,9029,9200,54720,41.91%
39659,39898,79557,11283,11444,11508,11471,11627,11708,69041,13.22%
20848,20784,41632,5187,5184,5252,5304,5335,5212,31474,24.40%
11655,11740,23395,2800,2761,2637,2806,2799,2682,16485,29.54%
32188,31898,64086,9221,9178,9325,9273,9118,9084,55199,13.87%
134,111,245,13,9,11,8,8,14,63,74.29%
33030,33015,66045,10014,9959,10141,10040,10059,10004,60217,8.82%
2855,2833,5688,810,798,754,801,767,842,4772,16.10%
48141,48787,96928,3867,3790,3888,3920,4003,3749,23217,76.05%
34157,34751,68908,795,802,765,816,803,759,4740,93.12%
48793,48785,97578,834,897,823,862,868,854,5138,94.73%
1188,1224,2412,320,340,311,291,327,312,1901,21.19%
3241,3297,6538,23,14,21,33,33,28,152,97.68%
30752,31078,61830,1544,1597,1634,1634,1562,1658,9629,84.43%
41217,40937,82154,815,820,853,786,803,838,4915,94.02%
35380,34996,70376,3649,3709,3678,3780,3665,3822,22303,68.31%
34111,34110,68221,10929,10901,10827,11022,10870,10936,65485,4.01%
49579,49762,99341,5171,5145,5160,5048,5213,5275,31012,68.78%
14731,14541,29272,1759,1728,1743,1793,1775,1741,10539,64.00%
46016,46150,92166,4955,4985,4945,4905,5017,4974,29781,67.69%
30289,29998,60287,8094,7956,7978,8131,7940,7967,48066,20.27%
45077,44849,89926,3615,3631,3485,3596,3546,3576,21449,76.15%
28924,29210,58134,5293,5234,5330,5295,5376,5250,31778,45.34%
24273,23988,48261,720,702,659,661,703,685,4130,91.44%
1901,1956,3857,116,128,136,118,117,144,759,80.32%
33470,33244,66714,1062,1076,1106,1104,1086,1092,6526,90.22%
39172,39054,78226,6286,6234,6312,6168,6326,6264,37590,51.95%
20690,20768,41458,1963,2002,2010,1958,2030,2051,12014,71.02%
21832,21720,43552,3006,3015,2979,2907,2905,2972,17784,59.17%
41315,41309,82624,10095,10163,10064,10126,10127,10117,60692,26.54%
38146,38483,76629,10656,10341,10633,10508,10450,10624,63212,17.51%
6041,6009,12050,2041,2049,1971,1997,1924,1922,11904,1.21%
39747,39795,79542,8033,8101,8076,8009,7952,8023,48194,39.41%
12768,12704,25472,355,375,350,345,349,366,2140,91.60%
44952,45417,90369,6848,6758,6716,6694,6951,6918,40885,54.76%
26785,26987,53772,3586,3740,3555,3731,3768,3732,22112,58.88%
22147,22338,44485,1114,1078,1115,1137,1093,1132,6669,85.01%
15037,14962,29999,2382,2422,2339,2299,2364,2437,14243,52.52%
13649,13619,27268,1535,1485,1522,1573,1551,1533,9199,66.26%
21922,21808,43730,2757,2680,2701,2774,2692,2649,16253,62.83%
32123,32343,64466,6189,6161,6285,6293,6452,6139,37519,41.80%
34423,34650,69073,3704,3622,3720,3632,3760,3766,22204,67.85%
13241,13018,26259,2136,2170,2008,2077,2150,2152,12693,51.66%
11857,11638,23495,1527,1482,1512,1508,1495,1479,9003,61.68%
39162,39525,78687,6183,6340,6186,6161,6157,5987,37014,52.96%
17736,17804,35540,4206,4161,4038,4161,4102,4054,24722,30.44%
18300,18113,36413,5800,5873,5858,5826,5792,5803,34952,4.01%
44767,44798,89565,10667,10939,10747,10864,10632,10952,64801,27.65%
16671,16362,33033,4342,4446,4403,4349,4444,4339,26323,20.31%
26006,26236,52242,2919,2912,2998,2854,2922,2887,17492,66.52%
34904,34580,69484,10458,10490,10665,10511,10494,10652,63270,8.94%
9050,9128,18178,2643,2451,2559,2575,2637,2586,15451,15.00%
25404,24964,50368,1586,1649,1650,1653,1590,1650,9778,80.59%
18571,18583,37154,1120,1136,1111,1081,1119,1104,6671,82.05%
23063,23431,46494,7232,7267,7204,7039,7115,7284,43141,7.21%
27884,27815,55699,6195,6067,6113,6228,6197,6072,36872,33.80%
5611,5466,11077,1458,1508,1447,1456,1497,1490,8856,20.05%
26548,26832,53380,6018,6056,6194,5960,6145,6032,36405,31.80%
21521,21486,43007,5017,5013,5067,4859,4958,4879,29793,30.73%
45663,45704,91367,10429,10288,10213,10334,10320,10364,61948,32.20%
45564,45659,91223,12463,12362,12631,12425,12454,12414,74749,18.06%
27857,27832,55689,3682,3747,3753,3720,3732,3739,22373,59.83%
17524,17601,35125,819,894,911,857,886,895,5262,85.02%
8766,8734,17500,1721,1904,1859,1907,1841,1778,11010,37.09%
738,782,1520,47,48,47,64,56,58,320,78.95%
402,409,811,48,57,64,75,47,50,341,57.95%
23128,23091,46219,2300,2322,2301,2407,2367,2354,14051,69.60%
41261,41449,82710,1595,1578,1645,1540,1630,1709,9697,88.28%
3208,3118,6326,308,304,309,319,315,272,1827,71.12%
47979,47953,95932,14291,14146,14020,13978,14043,14092,84570,11.84%
5025,4843,9868,1280,1212,1218,1287,1276,1228,7501,23.99%
46379,46504,92883,851,849,838,895,933,893,5259,94.34%
36734,37330,74064,4744,4735,4737,4726,4649,4634,28225,61.89%
45876,45871,91747,2474,2536,2569,2506,2463,2465,15013,83.64%
49853,49915,99768,16414,16031,16047,16062,16276,16341,97171,2.60%
47949,47993,95942,11838,12027,11739,11668,11697,11908,70877,26.13%
25216,25106,50322,7230,7157,7210,7295,7166,7051,43109,14.33%
3827,3902,7729,461,418,447,414,411,426,2577,66.66%
43309,43395,86704,7533,7417,7441,7369,7721,7421,44902,48.21%
46707,46965,93672,7977,8007,7980,7971,8077,8011,48023,48.73%
6841,6930,13771,520,503,482,486,527,508,3026,78.03%
10912,10941,21853,3227,3334,3322,3213,3249,3154,19499,10.77%
11791,11730,23521,383,380,375,362,374,362,2236,90.49%
15770,16137,31907,3553,3504,3491,3579,3533,3586,21246,33.41%
30509,30546,61055,8048,8107,8012,8129,8234,8062,48592,20.41%
47457,47436,94893,14604,14827,14610,14691,14929,14771,88432,6.81%
11624,11726,23350,2278,2274,2280,2350,2396,2373,13951,40.25%
37514,37550,75064,9435,9635,9522,9574,9479,9480,57125,23.90%
11188,11040,22228,2774,2800,2809,2801,2826,2841,16851,24.19%
9261,9195,18456,2336,2460,2427,2382,2389,2361,14355,22.22%
27486,27768,55254,209,178,229,204,197,201,1218,97.80%
49815,50076,99891,7234,7451,7333,7295,7228,7258,43799,56.15%
23317,22997,46314,1931,2006,1970,1994,2021,1987,11909,74.29%
13615,13530,27145,506,453,464,467,453,489,2832,89.57%
28369,28398,56767,2091,2082,2005,2087,2067,2191,12523,77.94%
34924,35030,69954,3880,4059,4108,3993,3973,4158,24171,65.45%
44324,44494,88818,5945,5984,5916,5922,6100,6092,35959,59.51%
42514,42492,85006,7374,7404,7505,7371,7438,7543,44635,47.49%
36789,36734,73523,699,651,685,659,651,631,3976,94.59%
46703,46470,93173,7700,7556,7542,7527,7787,7572,45684,50.97%
41239,41236,82475,4295,4282,4260,4247,4366,4312,25762,68.76%
29800,29422,59222,5315,5348,5310,5395,5422,5315,32105,45.79%
153,134,287,39,33,31,33,36,28,200,30.31%
14270,14080,28350,2347,2435,2432,2441,2392,2291,14338,49.43%
23075,22971,46046,2141,2059,2099,2112,2080,2034,12525,72.80%
10822,10833,21655,368,317,374,327,337,354,2077,90.41%
32691,33007,65698,8687,8573,8759,8670,8840,8649,52178,20.58%
10559,10594,21153,1394,1435,1419,1455,1495,1412,8610,59.30%
22157,21894,44051,5148,5054,5179,5227,5131,5069,30808,30.06%
13761,13771,27532,1126,1113,1095,1141,1113,1112,6700,75.66%
22105,22167,44272,537,581,555,585,563,557,3378,92.37%
18467,18540,37007,5676,5629,5556,5696,5696,5563,33816,8.62%
31530,31512,63042,4907,4849,4938,4830,4866,4863,29253,53.60%
32156,32041,64197,5383,5355,5405,5480,5495,5461,32579,49.25%
1311,1303,2614,338,320,313,351,345,328,1995,23.68%
40044,40264,80308,9616,9321,9482,9498,9558,9330,56805,29.27%
42524,42423,84947,8598,8578,8743,8628,8622,8541,51710,39.13%
14000,13950,27950,2492,2490,2534,2612,2469,2573,15170,45.72%
39908,39862,79770,1295,1243,1279,1232,1331,1297,7677,90.38%
35150,35101,70251,2111,2122,2029,2009,2070,2079,12420,82.32%
43908,43954,87862,2911,2953,2906,3022,3002,2942,17736,79.81%
27426,27592,55018,780,818,866,855,784,790,4893,91.11%
32127,32220,64347,9094,9536,9059,9090,9124,9220,55123,14.33%
16160,16333,32493,1777,1855,1841,1807,1827,1784,10891,66.48%
576,555,1131,93,73,74,77,87,79,483,57.29%
20887,20584,41471,3484,3402,3409,3511,3504,3456,20766,49.93%
17382,17554,34936,13,9,8,10,9,12,61,99.83%
2289,2284,4573,120,134,118,141,146,129,788,82.77%
8835,8668,17503,1611,1677,1661,1640,1607,1674,9870,43.61%
13970,13851,27821,726,695,724,768,734,682,4329,84.44%
26847,26525,53372,4566,4383,4579,4648,4598,4496,27270,48.91%
18449,18245,36694,5819,5742,5813,5916,5780,5840,34910,4.86%
36447,36394,72841,7655,7673,7677,7871,7957,7765,46598,36.03%
21373,21549,42922,6170,6127,6086,5987,6112,6046,36528,14.90%
43230,43234,86464,2863,2751,2894,2796,2889,2805,16998,80.34%
17674,17649,35323,2375,2296,2382,2461,2429,2266,14209,59.77%
12351,12246,24597,1994,2078,2034,2108,2005,2064,12283,50.06%
10084,10172,20256,3229,3231,3345,3235,3264,3180,19484,3.81%
39936,39746,79682,2185,2096,2066,2157,2107,2141,12752,84.00%
49245,49196,98441,4751,4541,4664,4667,4715,4603,27941,71.62%
31371,31604,62975,4766,4707,4622,4591,4600,4736,28022,55.50%
3781,3770,7551,691,767,743,726,728,727,4382,41.97%
12832,12915,25747,2770,2822,2794,2804,2840,2902,16932,34.24%
976,999,1975,107,92,84,111,83,95,572,71.04%
37865,38025,75890,3370,3393,3288,3486,3397,3354,20288,73.27%
18347,18520,36867,2280,2275,2275,2322,2298,2252,13702,62.83%
15048,15278,30326,3820,3929,4004,3902,3892,4022,23569,22.28%
4544,4579,9123,554,565,585,556,533,558,3351,63.27%
18283,18334,36617,2548,2606,2528,2521,2591,2579,15373,58.02%
29087,29410,58497,5930,5916,5941,5942,5962,6032,35723,38.93%
44434,44572,89006,9067,8765,8939,8627,9052,8678,53128,40.31%
13599,13602,27201,2490,2489,2556,2471,2475,2537,15018,44.79%
41489,41404,82893,11499,11491,11387,11386,11443,11535,68741,17.07%
444,454,898,1,4,7,6,10,7,35,96.10%
39123,39134,78257,2259,2275,2292,2180,2224,2289,13519,82.72%
2566,2538,5104,555,561,573,552,559,569,3369,33.99%
39969,39685,79654,1568,1464,1558,1506,1448,1502,9046,88.64%
8236,8205,16441,2308,2323,2237,2266,2295,2322,13751,16.36%
44224,43582,87806,4740,4779,4750,4664,4791,4659,28383,67.68%
25977,26059,52036,114,119,110,122,117,131,713,98.63%
20122,20138,40260,6648,6540,6495,6609,6574,6636,39502,1.88%
5011,5042,10053,386,380,395,405,424,411,2401,76.12%
10757,10231,20988,2907,2934,2893,2841,2793,3004,17372,17.23%
27633,27363,54996,309,301,300,262,303,282,1757,96.81%
19237,19355,38592,3936,3835,3903,3895,3957,3930,23456,39.22%
2057,2061,4118,566,590,589,550,552,573,3420,16.95%
31765,31715,63480,8934,8945,8885,9016,8965,9048,53793,15.26%
42929,42326,85255,3122,3020,3132,3027,3082,3022,18405,78.41%
48471,47999,96470,11118,11298,11330,11245,11286,11096,67373,30.16%
33622,34093,67715,1899,1945,1909,1908,1846,1794,11301,83.31%
32292,32282,64574,4152,4187,4187,4280,4254,4171,25231,60.93%
12478,12673,25151,2140,2100,2080,2090,2076,2025,12511,50.26%
26496,26982,53478,4655,4704,4531,4638,4601,4541,27670,48.26%
33659,33755,67414,3772,3776,3772,3697,3763,3718,22498,66.63%
26689,26554,53243,681,701,698,713,751,782,4326,91.87%
36522,36100,72622,7739,7741,7624,7613,7724,7687,46128,36.48%
25526,25989,51515,8003,8104,7879,8132,8001,8136,48255,6.33%
9995,10055,20050,2059,2082,2034,2010,2021,1936,12142,39.44%
4049,4131,8180,371,391,427,370,450,391,2400,70.66%
39070,38869,77939,4194,4258,4164,4293,4199,4231,25339,67.49%
4953,4957,9910,1227,1199,1199,1239,1252,1226,7342,25.91%
13725,13643,27368,1683,1739,1649,1747,1794,1703,10315,62.31%
3474,3471,6945,16,13,9,17,21,18,94,98.65%
13092,13078,26170,3793,3765,3663,3776,3758,3895,22650,13.45%
46182,46021,92203,8543,8380,8471,8244,8535,8279,50452,45.28%
16140,16293,32433,4350,4347,4393,4342,4332,4351,26115,19.48%
10247,9974,20221,901,829,808,876,905,856,5175,74.41%
38047,38030,76077,7960,7927,7939,7869,7919,7888,47502,37.56%
34496,34378,68874,9693,9668,9589,9533,9663,9790,57936,15.88%
30864,31086,61950,4485,4573,4555,4594,4519,4551,27277,55.97%
14660,14604,29264,4118,4076,4110,4120,4003,4021,24448,16.46%
5004,4786,9790,913,913,890,892,917,960,5485,43.97%
21754,21787,43541,5549,5472,5467,5635,5569,5519,33211,23.72%
14409,14325,28734,3533,3619,3692,3636,3687,3548,21715,24.43%
5049,5080,10129,1457,1444,1463,1498,1446,1511,8819,12.93%
41504,41964,83468,12901,12727,12759,12509,12387,12571,75854,9.12%
25252,25143,50395,3463,3474,3426,3459,3479,3386,20687,58.95%
14208,14111,28319,4230,4313,4324,4308,4356,4358,25889,8.58%
5970,5925,11895,149,176,148,172,153,148,946,92.05%
289,247,536,31,16,21,23,10,23,124,76.87%
15089,14966,30055,301,319,292,276,325,281,1794,94.03%
44371,44623,88994,482,481,518,510,483,475,2949,96.69%
21431,21675,43106,5747,5840,5898,5904,5797,5960,35146,18.47%
32492,32946,65438,10478,10500,10607,10364,10472,10555,62976,3.76%
300,309,609,75,70,78,68,71,72,434,28.74%
44486,44936,89422,5101,5011,5158,5176,5155,5076,30677,65.69%
7991,8170,16161,44,46,66,64,58,50,328,97.97%
23699,23626,47325,3045,3049,3068,2954,3010,2944,18070,61.82%
16373,16560,32933,4597,4614,4670,4597,4556,4542,27576,16.27%
13832,13894,27726,2380,2414,2456,2460,2324,2323,14357,48.22%
22370,22567,44937,32,41,31,39,37,31,211,99.53%
7369,7553,14922,370,408,381,426,425,354,2364,84.16%
28327,28268,56595,1155,1158,1115,1137,1131,1106,6802,87.98%
45464,45144,90608,11785,11683,11991,11698,11693,11689,70539,22.15%
30172,30465,60637,5817,5901,5858,5819,5841,5858,35094,42.12%
43041,42914,85955,12158,12219,12171,11999,12163,11932,72642,15.49%
42686,42951,85637,3644,3653,3651,3611,3744,3628,21931,74.39%
29224,29191,58415,7472,7517,7403,7682,7522,7423,45019,22.93%
22468,22390,44858,309,324,316,335,322,313,1919,95.72%
27170,27254,54424,3727,3705,3766,3802,3901,3768,22669,58.35%
6992,6889,13881,667,730,728,665,714,724,4228,69.54%
44449,44912,89361,13007,12804,12595,12537,12816,12841,76600,14.28%
15967,15825,31792,1564,1444,1561,1548,1539,1546,9202,71.06%
6418,6226,12644,2075,2067,2017,2052,2079,1964,12254,3.08%
19578,19169,38747,2249,2238,2253,2206,2273,2185,13404,65.41%
25976,26112,52088,1770,1715,1682,1768,1694,1705,10334,80.16%
3151,3335,6486,913,863,927,890,905,906,5404,16.68%
12679,12599,25278,2664,2618,2571,2660,2605,2637,15755,37.67%
16976,16870,33846,5178,5120,5087,5060,5161,5175,30781,9.06%
48525,49076,97601,3956,3886,3905,3873,3848,3980,23448,75.98%
46210,46117,92327,2749,2606,2664,2762,2645,2718,16144,82.51%
36279,36316,72595,9210,9286,9581,9124,9199,9146,55546,23.49%
21107,21414,42521,6010,5939,6096,6114,6073,6067,36299,14.63%
21879,21459,43338,2803,2801,2644,2804,2798,2813,16663,61.55%
21171,20915,42086,251,300,285,285,247,275,1643,96.10%
2410,2350,4760,409,394,419,445,420,429,2516,47.14%
43419,43044,86463,3708,3811,3954,3846,3882,4001,23202,73.17%
4986,4826,9812,1350,1364,1349,1362,1395,1303,8123,17.21%
11409,11325,22734,2347,2376,2346,2298,2356,2407,14130,37.85%
41660,41377,83037,679,593,624,704,659,659,3918,95.28%
39606,39541,79147,5970,6040,6030,6032,6107,5969,36148,54.33%
7373,7343,14716,577,539,554,578,593,535,3376,77.06%
25392,25074,50466,5790,5924,5769,5879,5799,5857,35018,30.61%
1009,961,1970,98,96,83,89,91,94,551,72.03%
2819,2775,5594,203,194,207,220,211,193,1228,78.05%
3557,3641,7198,709,672,687,685,666,684,4103,43.00%
48998,49424,98422,9691,9522,9711,9701,9653,9624,57902,41.17%
26741,26868,53609,1888,1891,1764,1799,1850,1825,11017,79.45%
27216,27291,54507,7297,7141,7269,7186,7152,7129,43174,20.79%
38044,38240,76284,6602,6402,6438,6434,6563,6189,38628,49.36%
39301,39264,78565,11045,11191,10868,11092,11173,11106,66475,15.39%
22048,21999,44047,1728,1749,1648,1732,1766,1746,10369,76.46%
16650,16493,33143,2814,2928,2881,2829,2891,2905,17248,47.96%
42648,42941,85589,631,681,664,648,678,617,3919,95.42%
14779,14780,29559,940,901,962,923,949,952,5627,80.96%
14489,14137,28626,497,509,483,509,453,496,2947,89.71%
12857,12692,25549,3383,3339,3415,3492,3513,3560,20702,18.97%
14572,14568,29140,2832,2736,2756,2785,2748,2696,16553,43.19%
41993,42007,84000,8446,8356,8497,8417,8484,8329,50529,39.85%
28600,28507,57107,5017,4889,4859,4909,5037,5093,29804,47.81%
21202,21290,42492,432,427,449,423,431,472,2634,93.80%
26165,26217,52382,7833,7730,7779,7526,7611,7627,46106,11.98%
46684,46938,93622,10276,10428,10294,10256,10220,10421,61895,33.89%
8261,8345,16606,2118,2125,2037,2068,2088,2116,12552,24.41%
18074,18200,36274,996,988,957,982,986,970,5879,83.79%
16311,16375,32686,4972,4971,4943,4939,4982,4898,29705,9.12%
42358,42182,84540,6265,6320,6341,6075,6246,6436,37683,55.43%
11437,11311,22748,1537,1625,1662,1559,1505,1580,9468,58.38%
10681,10649,21330,1096,1060,1041,1074,1070,1122,6463,69.70%
11729,11766,23495,1382,1423,1403,1467,1376,1376,8427,64.13%
29233,29109,58342,4767,4918,4899,4860,4841,5012,29297,49.78%
39095,39226,78321,11199,11277,11120,11172,10998,11163,66929,14.55%
34186,34103,68289,8895,9118,9103,9055,9049,8844,54064,20.83%
20399,20666,41065,556,511,501,551,533,535,3187,92.24%
40023,40018,80041,10762,11199,10782,11086,11090,11104,66023,17.51%
23925,23633,47558,4739,4641,4734,4644,4586,4641,27985,41.16%
8548,8498,17046,2137,2097,2128,2068,2133,2165,12728,25.33%
4112,4077,8189,373,375,372,373,367,370,2230,72.77%
37827,37979,75806,1510,1464,1457,1408,1521,1445,8805,88.38%
12149,12360,24509,3404,3355,3342,3295,3368,3393,20157,17.76%
15655,15512,31167,3463,3272,3142,3215,3347,3325,19764,36.59%
18350,18543,36893,5460,5598,5512,5628,5445,5436,33079,10.34%
37878,37881,75759,11404,11142,11231,11239,11066,11406,67488,10.92%
24936,24956,49892,2237,2279,2229,2181,2169,2123,13218,73.51%
43610,43567,87177,2662,2666,2672,2685,2732,2729,16146,81.48%
33462,33686,67148,5679,5852,5838,5767,5571,5679,34386,48.79%
45984,45847,91831,1699,1639,1592,1647,1594,1512,9683,89.46%
11613,11787,23400,1034,1056,1046,998,1024,1076,6234,73.36%
40021,39942,79963,10563,10686,10551,10453,10714,10580,63547,20.53%
2502,2506,5008,339,314,319,338,337,308,1955,60.96%
39683,39462,79145,12929,12801,12852,12702,12759,12727,76770,3.00%
43204,43724,86928,11095,10883,10937,10987,11127,11070,66099,23.96%
39195,39091,78286,4504,4480,4508,4450,4311,4508,26761,65.82%
42471,42683,85154,5140,4969,5016,5134,4977,4965,30201,64.53%
41454,41217,82671,1769,1666,1785,1795,1685,1748,10448,87.36%
35413,35150,70563,164,157,164,172,165,161,983,98.61%
32162,32047,64209,4189,4120,4357,4274,4163,4063,25166,60.81%
45260,45016,90276,4525,4593,4614,4431,4539,4558,27260,69.80%
24822,24654,49476,3680,3603,3700,3599,3729,3634,21945,55.65%
29032,28848,57880,9012,9099,9276,9228,9266,9204,55085,4.83%
5436,5558,10994,1044,998,963,1060,1007,987,6059,44.89%
33366,33183,66549,284,309,327,302,316,278,1816,97.27%
13332,13647,26979,188,155,172,191,182,183,1071,96.03%
2308,2318,4626,215,220,235,235,229,191,1325,71.36%
29702,29616,59318,3166,3212,3120,3296,3138,3132,19064,67.86%
45213,45151,90364,14233,14492,14460,14448,14473,14470,86576,4.19%
24308,24481,48789,2090,2069,1969,2089,2041,2143,12401,74.58%
4319,4325,8644,887,867,883,816,871,876,5200,39.84%
2637,2582,5219,839,831,843,823,837,801,4974,4.69%
17444,17522,34966,4747,4718,4625,4675,4766,4774,28305,19.05%
30461,30648,61109,6541,6576,6514,6522,6616,6588,39357,35.60%
13410,13297,26707,4117,4056,4013,4100,4004,4040,24330,8.90%
33189,33434,66623,5333,5103,5250,5250,5419,5217,31572,52.61%
38554,39138,77692,9266,9306,9236,9162,9342,9306,55618,28.41%
32398,32656,65054,7256,7392,7139,7139,7353,7484,43763,32.73%
7192,7269,14461,1350,1262,1275,1320,1331,1286,7824,45.90%
29587,29679,59266,7201,7293,7291,7462,7270,7120,43637,26.37%
30386,30361,60747,4984,4848,4875,4978,4742,4901,29328,51.72%
8661,8760,17421,567,566,625,628,580,581,3547,79.64%
25815,26436,52251,4137,4089,4087,4086,4050,4082,24531,53.05%
3652,3822,7474,470,482,495,502,490,460,2899,61.21%
14217,14014,28231,4585,4732,4619,4757,4624,4609,27926,1.08%
27520,27438,54958,9062,9123,9000,9006,8833,8921,53945,1.84%
45190,45056,90246,11207,11127,11150,11254,11051,11028,66817,25.96%
14442,14051,28493,3964,4235,4135,4134,4194,4291,24953,12.42%
16742,16927,33669,4845,4707,4800,4724,4814,4781,28671,14.84%
49605,49811,99416,14242,14051,14066,14060,14421,14139,84979,14.52%
21107,21267,42374,79,87,82,91,85,108,532,98.74%
43911,44234,88145,2403,2403,2359,2376,2415,2396,14352,83.72%
4484,4463,8947,1374,1444,1444,1429,1347,1357,8395,6.17%
10651,10650,21301,3297,3480,3415,3452,3414,3426,20484,3.84%
28680,28460,57140,3318,3219,3260,3254,3208,3189,19448,65.96%
40963,40435,81398,3166,2846,2959,3025,3013,3010,18019,77.86%
22289,21958,44247,6920,6781,6840,6692,6592,6752,40577,8.29%
7250,7243,14493,800,792,769,798,816,797,4772,67.07%
33424,32834,66258,1364,1332,1364,1312,1362,1314,8048,87.85%
15966,15647,31613,1832,1871,1812,1821,1827,1940,11103,64.88%
10212,10095,20307,2785,2731,2729,2654,2660,2765,16324,19.61%
18403,18569,36972,4359,4471,4430,4583,4491,4495,26829,27.43%
24079,24128,48207,2832,2892,2849,2791,2774,2878,17016,64.70%
21184,20902,42086,6883,6984,7087,6794,6897,6953,41598,1.16%
10168,9985,20153,3359,3316,3375,3343,3293,3410,20096,0.28%
1529,1637,3166,449,496,504,468,522,499,2938,7.20%
